XXXXXXXXXXXXXXXXXXXXXX
XFLLLLLLLLLRXXEXEXXEXX
XXXXXXXXXXXMXXILJGLJCX
XXEXXEXXXXXMXXMXXDXXXX
XXILLHXXTLLHXXMXXXXXXX
XXDXXMXXMXXMXFJGLLLLRX
XXXXFJLLSXXMXXX4XXXXMX
XXXEXXXXXXXMXXXXXTLLSX
XFGJLLLLGLLJLLLRXMXXXX
XXMXXXXXMXXXXXXMXMXEXX
XXULRXXXULLLLRXMXULHXX
XXXXMXXXXXXXXMXMXXXMXX
XTLLSXTLRXXTLSXILGLJCX
XMXXXXMXMXXMXXXDXMXXXX
XULLLLSXULLJCXXXXULLCX
XXXXXXXXXXXXXXXXXXXXXX